XXXXXXXXXXXXXXXXXXXXXXXXXXXXXXXXXXXXXXXX
X--------------X---O-X--------H--------X
X--------VM-M--X-XXXXX--X--X-X-X-X-X-X-X
X--H-X--X-XVXVXX-X------XXXXXXXXXXXXXX-X
X-H--X----M-M-M--X-V-XXXX--MMMMMMMMM---X
X--H-XXXXXXXXXXXXX---X-----XXXXXXXXXXXXX
X-----X---X-----H----X---H-X--------CCCX
X-----X-X-X-XXXXXXXXXX-----X-XXXXXXXCCCX
X-------X---XMMMMMMMMM---X------H------X
XXXXXXXXXXXXXXXXXXXXXXXXXXXXXXXXXXXXXXXX
