XXXXXXXXXXXXXXXXXXXXXXXXXXXXXXXXXXXXXXXX
X---------X-X-X-X---X-MMM--MMM-CCCCCCCCX
X----X--V-X----H----X-M--MM--M-XXXXXXXXX
X-H-XXX---------X---X--MM--MM----------X
X-M-X-XXXXXXXXXXX-O-XXXXXXXXXXXXXXXX---X
X-H-X---M-------X---X--M-----H-----X---X
X-M-X-V-------V-XXXXX-----XXXXXX---X---X
X-M-X-----V------X-M-X-M--X-------H----X
X-----------M------X-M-X--XMMMX---H----X
XXXXXXXXXXXXXXXXXXXXXXXXXXXXXXXXXXXXXXXX
