XXXXXXXXXXXXXXXXXXXXXXXXXXXXXXXXXXXXXXXX
X-MMM-X-----------H-----X-------H------X
X--XX---X-X-X-X-X-X-X-X---XXX-XXXX--M--X
X--X-X-X-X-X-X-X-X-X-X-X-X---XXCCX--M--X
X----------------H---------X-CCCCX--M--X
XXXXXXXXXXXXXXXXXXXXXXXXXXXXXXXXXX--H--X
X-------MM-------------------MM-----M--X
XO----V----V-----V-M-V----V------V--M--X
X------------MMM--------------------M--X
XXXXXXXXXXXXXXXXXXXXXXXXXXXXXXXXXXXXXXXX
